quite = bastante/muito
full of things = cheia
well = bom
if it does not come out right = se não der certo
bring = trazer
medium = médio
It's very kind of you = é legal da sua parte
aisles = corredores do mercado
she walks down the aisles = levando o carrinho
trolley = carrinho
rows of shelves = fileiras de pratilheiras
boot = porta malas
trousers = calça
tire was flat = o pneu furou
excuse = desculpa
properly=devidamente
trooly=<F9>
surplus = excesso
effort = esforço
wide = aberto
spread = genenalizada
its bit = sua parte
bin = lixeira
overlooked = ignore/forgot
unleashe = força desnecessária
decry=sensurar
amid = between
strife = crises
along = em frente
witnesses = testemunha
heating = aquecedor
fence = grade
bother=incomodar
getting in the way = atrapalhando

expat = expatriact
tapping = on top of an issue
befriending=amigavel
livable stipend = bolsa
landmark = ponto de interesse
working sites = canteiro de obras
to boo = vaiar
polls = intenção de votos
I go with my guts = eu vou com meu estômago

